11100110010000101000011110111000001110011110111101111111
10001001010000101000010000100100001001010000100000001000
11001111010000110000011000100100001010011000111100001000
10001001010000101000010000111000001001010000000100001000
10001001011110101000011110100100001111011110111100001000